<TICKER>        <NAME>
ACP	ASSECOPOL
ALE	ALLEGRO
CCC	CCC
CDR	CDPROJEKT
CPS	CYFRPLSAT
DNP	DINOPL
JSW	JSW
KGH	KGHM
LPP	LPP
LTS	LOTOS
MRC	MERCATOR
OPL	ORANGEPL
PEO	PEKAO
PGE	PGE
PGN	PGNIG
PKN	PKNORLEN
PKO	PKOBP
PZU	PZU
SPL	SANPL
TPE	TAURONPE